{
  "player": [2, 2],
  "goal": [7, 6],
  "map": [
    "##########",
    "#        #",
    "#  ####  #",
    "#  #     #",
    "#  #  ####",
    "#     #  #",
    "#  ####  #",
    "#        #",
    "##########"
  ]
}
